F  225,255,211    
R 100 100
NO textures/diamond.xpm
SO textures/gress.xpm
EA textures/gravel.xpm
WE textures/sand.xpm
S textures/item.xpm
C  255,255,255

1111111111111
1           1
1           1
11111111111111
10000000000001
1000000E000001
10000200000001
10000000000001 
11111111111111
