R 14000 10000
NO textures/diamond.xpm
SO textures/gress.xpm
EA textures/gravel.xpm
WE textures/sand.xpm
S textures/item.xpm
C  167,208,205
F  160,147,125    
        1111111111111111111111111
  0     1000000000000000000000001
   0    1100000000200200000000201
        1000000200002222222222201
1111111110000000000002000000000N1
100000000000000000000000000001101
100000000000000111111100000001111
1000000000000001    1100000001
1000000000000001 1110100002001
100000000000000111010100000001
1000000000000001 1000000000001
1100000111010101 1111011110101
11110111 1110101 101111011011
11111111 1111111 111111111111
