F  225,255,211    
R 1000 400
NO textures/diamond.xpm
SO textures/gress.xpm
EA textures/gravel.xpm
WE textures/sand.xpm
S textures/item.xpm
C  255,255,255

111111111111111111111
1           111111111
1           111111111
111111111111111111111
100200000000011111111
1000000W0000011111111
100002000000011111111
100000000000011111111
111111111111111111111
