F  225,34,211    
R 1280 1024
NO textures/eagle.xpm
SO textures/redbrick.xpm
EA textures/wood.xpm
WE textures/mossy.xpm
S textures/greystone.xpm
C  255,255,255

        1111111111111111111111111
  0     1000000000000000000000001
   0    11000000W0000000000000001
        1000000000000000000000001
111111111000000000000000000000001
100000000000000000000000000001101
100000000000000111111100000001111
1000000000000001    1100000001
1000000000000001 1110100000001
100000000000000111010100000001
1000000000000001 1000000000001
1100000111010101 1111011110101
11110111 1110121 101111011011
11111111 1111111 111111111111
