F  225,255,211    
R 1320 420
NO   ./a.xpm
SO   ./a.xpm
EA ./a.xpm
WE ./a.xpm
C  255,255,255

1111111111111
1     E     1
1           1
11111111111111
10000000000001
10000000000001
10000000000001
1000000000001 
11111111111111
