R 10024 10768
NO textures/eagle.xpm
SO textures/redbrick.xpm
EA textures/wood.xpm
WE textures/mossy.xpm
S textures/greystone.xpm
C  0,0,0
F  111,79,40    

        1111111111111111111111111
  0     1000000000000000000000001
   0    1100000000000000000000001
        1000000000000000000000001
11111111100000000000000000W000001
100000000000000000000000000001101
100000000000000111111100000001111
1000000000000001    1100000001
1000000000000001 1110100000001
100000000000000111010100000001
1000000000000001 1000000000001
1100000111010101 1111011110101
11110111 1110121 101111011011
11111111 1111111 111111111111
