F  225,255,211    
R 1320 450
NO   ./a.xpm
SO   ./a.xpm
EA ./a.xpm
WE ./a.xpm
C  255,255,255

11111111111111
10000000000001
10000000000001
10000000000001
100000N0000001
11111111111111
