F  225,,211    
R 1320 420
NO   ./a.xpm
SO   ./a.xpm
EA ./a.xpm
WE ./a.xpm
S ./a.xpm
C  255,255,255

        1111111111111111111111111
  0     1000000000000000000000001
        1100000000000000000000001
        1000000000000000000000001
111111111000000000000000000000001
100000000000000000000000000001111
10000000000000E11111110000000100
1000000000000001    110000000000
1000000000000001 111010000000100
10000000000000011101010000000100
1000000000000001 100000000000100
1100000111010101 111101111010100
11110111 1110121 10111101000100
11111111 1111111 11111111111100
